 ************************************************************************************************************
 ************************************************************************************************************
 ****E **                      **                  **                                              **      **
 ****  **  ******************  **  **********  **  **********  **********************************  **  **  **
 ****  **      **  **          **  **          **              **      **                  **  **  **  **  **
 ****  ******  **  **  **************  **************************  ******  **********  **  **  **  **  **  **
 ****          **  **              **  **          **      **              **          **      **  **  **  **
 ****************  **************  **  **  ******  **  **  ******  **********  **************  **  ******  **
 ****              **              **          **      **      **      **      **      **      **      **  **
 ****  **************  **************************************  **********  ******  ******  **********  **  **
 ****                  **      **              **              **          **      **      **          **  **
 ****  ******************  **  **  **  ******  **  **************  **********  ******  ******  **********  **
 ****              **      **  **  **  **      **  **      **      **          **          **  **      **  **
 ****************  ******  **  **  **  **  ******  **  ******  **  **********  **  **********  **  **  **  **
 ****  **      **          **  **  **  **          **  **      **  **      **      **  **      **  **      **
 ****  **  **  **************  ******  **************  **  ******  **  **  **  ******  **  ******  ******  **
 ****      **              **      **  **                  **  **      **  **          **  **      **  **  **
 ****  **************  **********  **  **  ******************  **********  **********  **  **  ******  **  **
 ****  **          **  **      **  **  **                  **      **      **      **  **  **      **  **  **
 ****  **  ******  **  **  **  **  **  ******************  ******  **  ******  **  ******  ******  **  **  **
 ****      **      **      **          **                          **          **                  **    s **
 ************************************************************************************************************
 ************************************************************************************************************