****=**
*   * E
* = * *
* *s* *
* *** *
*     *
*******