*******
*   * E
* * * *
* *s* *
* *** *
*     *
*******