******
*    *
*E s *
*    *
******